Cancel=Avbryt

; My PSAs / banners
Happy New Year=Godt Nytt År
Happy Holidays from Andrew, Tracey, and family=God høytid fra Andrew, Tracey og familien
Please Enjoy Responsibly=Vennligst Nyt Ansvarligz<
Popup Blocked CA requires popups to be enabled under certain circumstances You must white list your server within your browser to allow popups=Popup-blokkert CA krever at popup-vinduer er aktivert under visse omstendigheter. Du må hvitliste  serveren din i nettleseren din for å tillate popup-vinduer
Docker Service Not Enabled - Only Plugins Available To Be Installed Or Managed=Docker-tjenesten er ikke aktivert - bare programtillegg er tilgjengelig for å bli installert eller administrert
Community Applications works best when cookies are enabled in your browser Certain features may not be available=Samfunnsapplikasjoner fungerer best når informasjonskapsler er aktivert i nettleseren din. Visse funksjoner er kanskje ikke tilgjengelige
Backup Server Active Some icons may not appear, and plugin installations may be affected=Backup Server aktiv. Noen ikoner vises kanskje ikke, og programtillegg-installasjoner kan påvirkes

; Sorting Options
Sorting options=Sorteringsalternativer
Sorting options unavailable=Sorteringsalternativer utillgjengelig
Sort By Name Ascending=Sorter etter navn stigende
Sort By Name Descending=Sorter etter navn synkende
Sort By Downloads=Sorter etter Nedlastninger
Sort By Trend=Sorter etter Trend
Sort By Date Added=Sorter etter dato lagt til
; Initial disclaimer translations
Disclaimer=ansvarsfraskrivelse
All applications listed here are 3rd party additions to Unraid Neither the authors of Community Applications nor Limetech make any warranty as to the suitability of any application listed here=Alle applikasjoner som er oppført her, er tredjeparts tillegg til Unraid Verken forfatterne av Community Applications eller Limetech gir noen garanti for egnetheten til applikasjoner som er oppført her
Every attempt is made to ensure that only safe and compatible applications are present=Alt blir gjort for å sikre at bare sikre og kompatible applikasjoner er til stede
Application Policy=Programvarepolicy
I Understand=Jeg forstår
Installations of apps disabled You must accept the warning to be able to install applications=Installasjoner av apper deaktivert Du må godta advarselen for å kunne installere applikasjoner
Click here=Klikk Her

; Plugin Disclaimer
Community Applications contains both docker containers and plugin applications Plugins are designed for OS enhancements, and run with full privileges on your system and are clearly identified within CA=Community Applications inneholder både dockercontainere og plugin-applikasjoner Plugins er designet for OS-forbedringer, og kjøres med full rettighet på systemet ditt og er tydelig identifisert i CA
Plugin Note=Plugin Merknad

; Multi Install
Install Plugin Applications=Installer plugin-applikasjoner
Select all on page=Velg alt på siden

; Searches
Search=Søk
Please enter search term=Vennligst skriv inn søkeord
Click Here To Get More Results From DockerHub=Klikk her for å få flere resultater fra Docker Hub
No Matching Applications Found On Docker Hub=Ingen samsvarende applikasjoner funnet på Docker Hub
No Matching Applications Found=Ingen samsvarende applikasjoner funnet

; Install Plugin title of openbox
Install Plugin=Installer programtillegg

; Remove App from previously installed
Delete Template=Slett Mal
Yes, delete it=Ja. Slett det

; Uninstall popup
Uninstall Application=Avinstallere applikasjon
Yes uninstall it=Ja. Slett det

; Remove Private Application
Remove Private Application=Avinstallere applikasjon
Yes, remove it=Ja. Slett det

; App Pinning
Click to pin this application=Klikk for å feste dette programmet	
Click to unpin this application=Klikk for å løsne denne applikasjonen

; Branch installations
Choose A Branch To Install=Velg en gren som skal installeres

; Multiple application installs
; no apps selected
Install Selected Applications=Installer valgte applikasjoner

Yes, install it=Ja, installer programmet

; Multi-install popup
Yes, install them=Ja, installer programmene
Cookies not enabled Plugins must be separately installed from docker applications=Cookies som ikke er aktivert Programvaretillegg må installeres separat fra docker-applikasjoner
Docker applications will be installed utilizing the most recently saved template with no user input on your part=Docker-applikasjoner vil bli installert ved å bruke den sist lagrede malen uten brukerinngang fra din side
Updating Support Links=Oppdaterer støttekoblinger
Finished Installing If the DONE button did not appear, then you will need to click the red X in the top right corner=Ferdig installasjon Hvis FERDIG-knappen ikke dukket opp, må du klikke på den røde Xen øverst til høyre

; error messages
No data was returned It is probable that another browser session has rebooted your server Reloading this browser tab will probably fix this error=Ingen data ble returnert Det er sannsynlig at en annen nettleserøkt har startet serveren din på nytt. Å laste denne nettleserfanen vil trolig løse denne feilen
An error occurred Could not find any %s Apps=Det oppstod en feil Fant ingen %s apper
Download of appfeed failed=Nedlasting av applikasjons strøm mislyktes
; the %s here refers to a function being called
Something really went wrong here=Noe gikk virkelig galt her
Post the ENTIRE contents of this message in the Community Applications Support Thread=Legg ut HELE innholdet i denne meldingen i støttetråden for fellesskapsapplikasjoner
Unknown error happened Please post a screenshot in the support thread of the Statistics screen=Ukjent feil skjedde. Legg ut et skjermbilde i støttetråden på statistikkskjermen
Something really wrong happened Reloading the Apps tab will probably fix the problem=Noe virkelig galt skjedde. Å laste inn app-fanen vil trolig løse problemet
This plugin has a duplicated name from another plugin %s This will impact your ability to install both plugins simultaneously=Dette pluginet har et duplisert navn fra et annet plugin %s Dette vil påvirke muligheten din for å installere begge plugins samtidig
You have been logged out=Du har blitt logget ut

; CA Sections Keep the length reasonable
MENU=Meny
Installed Apps=Installerte apper
Previous Apps=Tidligere apper
Pinned Apps=Festede apper
CATEGORIES=Kategorier
New Apps=Nye Apper
Updated Apps=Oppdaterte apper
Random Apps=Tilfeldige apper
Top New Installs=Topp nye installasjoner
Trending Apps=Populære apper
All Apps=Alle apper
OTHER=Diverse
Statistics=Statistikk
Credits=Bidragsytere
Support=Støtte
VERSION=VERSJON
Change Log=Endringslogg

; Credits
Development=Utviklere 
Additional Contributions=Bidragsytere
GUI Layout Design=GUI Design
Application Feed=Applkasjons strøm
Additional Testing=Testing
Moderation=Moderering 
Additional Libraries=Inkluderte bibliotek
Copyright=Opphavsrett
Translation=Oversettelse

; Statistics page
Deprecated Applications are able to still be installed if you have previously had them installed New installations of these applications are blocked unless you enable Display Deprecated Applications within CAs General Settings=Utfasede applikasjoner kan fortsatt installeres hvis du tidligere har hatt dem installert Nye installasjoner av disse applikasjonene er blokkert med mindre du aktiverer Vis utdaterte applikasjoner i CAs Generelle innstillinger
The following applications are blacklisted CA will never allow you to install or reinstall these applications=Følgende applikasjoner er svartelistet, CA vil aldri tillate deg å installere eller installere disse programmene på nytt
While highly not recommended to do, incompatible applications can be installed by enabling Display Incompatible Applications within CAs General Settings=Selv om det ikke anbefales å gjøre det, kan inkompatible applikasjoner installeres ved å aktivere skjermkompatible applikasjoner i CAs Generelle innstillinger
This display is informational ONLY=Denne skjermbilde er KUN informativt
unknown=ukjent
Last Change To Application Feed=Siste endring i applikasjonsstrøm
Number Of Docker Applications=Antall Docker-applikasjoner
Number Of Plugin Applications=Antall Programvaretillegg
Number Of Templates=Antall Maler
Number Of Repositories=Antall arkiver
Number Of Private Docker Applications=Antall private Docker-applikasjoner
Number Of Invalid Templates=Antall ugyldige maler
Number Of Template Errors=Antall maler med feil
Number Of Blacklisted Apps=Antall apper på svartelisten
Number Of Incompatible Applications=Antall inkompatible applikasjoner
Number Of Deprecated Applications=Antall utdaterte applikasjoner
Number Of Moderation Entries=Antall moderasjonsoppføringer
Primary Server=Primær server
Backup Server=

; Statistics Popup Titles
Repository List=Datalagerliste
All Invalid Templates Found=Alle ugyldige maler funnet
Template Errors=Malfeil
All Moderation Entries=Alle moderasjonsoppføringer

; Statistics Popup
No invalid templates found=Fant ingen ugyldige maler
These templates are invalid and the application they are referring to is unknown=Disse malene er ugyldige, og applikasjonen de henviser til er ukjent
No templates were automatically fixed=Ingen maler ble automatisk løst
All of these errors found have been fixed automatically=Alle disse feilene ble løst automatisk
Note that many of these errors can be avoided by following the directions=Merk at mange av disse feilene kan unngås ved å følge instruksjonene
HERE=HER
The following plugins have duplicated filenames and are not able to be installed simultaneously=Følgende programtillegg har dupliserte filnavn og kan ikke installeres samtidig
The following docker applications refer to the same docker repository but may have subtle changes in the template to warrant this=Følgende docker-applikasjoner refererer til samme docker-depot, men kan ha subtile endringer i malen for å garantere dette
If any of these entries are incorrect then contact the moderators of CA to discuss=Hvis noen av disse oppføringene er feil, så kontakt moderatorene for CA for å diskutere
Global Repository Comments=Globale depotkommentarer
Applied to all applications=(Brukes på alle applikasjoner)
Individual Application Moderation=Individuell applikasjons moderering

; Misc
Community Applications Changelog=Samfunnsapplikasjonens Endringslogg

; Categories try not to be excessively long This is displayed on the left of CA screen

Backup=
Cloud=Skytjenester
Downloaders=Nedlastere
Game Servers=Spillservere
Home Automation=Hjemme automatisering
Media Applications=Media applikasjoner
Books=Bøker
Music=Musikk
Photos=Bilder
Video=Video
Other=Andre
Media Servers=Media server
Network Services=Nettverks Tjenester
DNS=
FTP=
Management=
Messenger=Meldinger 
Proxy=
VOIP=
VPN=
Web=
Productivity=Productivitet
Security=Sikkerhet
Tools Utilities=Verktøy
Themes=Utseende
Utilities=Verktøy
Private Apps=Private applikasjoner
Uncategorized=Ukategorisert 

; Categories displayed within a popup or on the card.  Where an entry exists after the "=" it is not translated, but rather how it should look
GameServers=Spillservere
HomeAutomation=Hjemme automatisering
MediaApp=
MediaAppBooks=MediaApp:Bøker
MediaAppMusic=MediaApp:Musikk
MediaAppPhotos=MediaApp:Bilder
MediaAppVideo=MediaApp:Video
MediaAppOther=MediaApp:Andre
MediaServer=
MediaServerBooks=MediaServer:Bøker
MediaServerMusic=MediaServer:Musikk
MediaServerPhotos=MediaServer:Bilder
MediaServerVideo=MediaServer:Video
MediaServerOther=MediaServer:andre
Network=Nettverk
NetworkDNS=Nettverk:DNS
NetworkFTP=Nettverk:FTP
NetworkManagement=Nettverk:Management
NetworkProxy=Nettverk:Proxy
NetworkVOIP=Nettverk:VOIP
NetworkVPN=Nettverk:VPN
NetworkWeb=Nettverk:Web
NetworkOther=Nettverk:Other
ToolsSystem=Verktøy:System
ToolsThemes=Verktøy:Themes
ToolsUtilities=Verktøy:Utilities
Other=Andre
OtherUncategorized=Andre:Ukategorisert

; App Popup Related
Donate To Author=Donèr til Forfatter
Donate To Maintainer=Donèr til Vedlikeholder
Author=Forfatter
Maintainer=Vedlikeholder
DockerHub=
Application Template=Applkasjonsmal
Base OS=
DockerHub Stars=DockerHub Stjerner
Added to CA=Lagt til i CA
Date Updated=Dato Oppdatert
Current Version=Nåværende Versjon
Minimum OS=Minstekrav Operativ System
Max OS=Maks Operativ System tillatt
Total Downloads=Totalt antall nedlastninger
Licence=Lisens
30 Day Trend=30 Dagers trend
Ranked #%s=
; as in Trending up or down arrow
Trending %s=
; as in As of some date
As of %s=(As of %s)
This application template has been blacklisted=Denne applikasjonsmalen er svartelistet
This application template has been deprecated=Denne applikasjonsmalen er avviklet
This application is not compatible with your version of Unraid=Denne applikasjonen er ikke kompatibel med din versjon av Unraid
Another browser tab or device has updated the displayed templates Some actions are not available=En annen nettleserfane eller enhet har oppdatert malene som vises. Noen handlinger er ikke tilgjengelige
Reinstall default=Installer standard
WebUI=Nettlesergrensesnitt
Reinstall=Reinstaller
Install=Installer
Project=Prosjekt
Install Using The Templates Default Tag=Installer ved hjelp av Siste versjonsmerke 
Moderator Comments=Moderatorkommentarer:
Note not all authors keep up to date on change logs=Merk at ikke alle forfattere holder seg oppdatert på endringslogger
Note not all maintainers keep up to date on change logs=Merk at ikke alle vedlikeholdere holder seg oppdatert på endringslogger
;the following if using a space you MUST use nbsp but keep it down to one word if at all possible
Donate=Donèr
Currently Installed Version=Nåværende installerte versjon
Install The Update=Installer oppdatering 
; as in you have the latest version already installed
Latest Version=Siste versjon
Multi Language Support=Fler språkstøtte 
; as in more than 100000
More than %s=Mer enn

; Graphs
Trend Per Month=Trend Per Måned
Downloads Per Month=Nedlastninger Per Måned
Total Downloads=Antall nedlastninger

; Multi install script
Installing docker applications %s=Installerer docker-applikasjoner %s
Starting %s=Starter %s
%s failed to start You should install it by itself to fix the errors=%s mislyktes i å starte. Du bør installere den av seg selv for å fikse feilene
Setting installed applications to autostart=Angi installerte applikasjoner til automatisk start
Docker Application Installation finished=Installasjonen av Docker-applikasjonen er fullført

; Application Cards
Private dockerHub Conversion=Privat (dockerHub Konvertering)
Go to the project page=Gå til prosjekt siden
Go to the support thread=Gå til støttetråden
Uninstall Application=Avinstallere Program
Remove Private Application=Fjern Privat Program
Remove Application From List=Fjern Applkasjon fra listen
Check off to select multiple reinstalls=Kryss av for å velge flere installasjoner på nytt
Go to the plugin settings=Gå til programtilleggs innstillinger
Click to reinstall the application using default values=Klikk for å installere programmet på nytt ved hjelp av standardverdier
Click to edit the application values=Klikk for å redigere programverdiene
Click to reinstall=Klikk for å installere på nytt
Click to install=Klikk for å installere
Install plugin=Installer Programvaretillegg
Click to go to the WebUI=Klikk for å gå til Nettlesergrensesnitt
This application has been marked as being Beta=Denne applikasjonen er merket som BETA versjon
This application template has been deprecated=Denne applikasjonsmalen er avviklet
This application is not compatible with your version of Unraid=Denne applikasjonen er ikke kompatibel med din versjon av Unraid
This application template has been blacklisted=Denne applikasjonsmalen er svartelistet
Search for more applications from %s=Søk etter flere applikasjoner fra %s
Click for more information=Klikk for mer informasjon

; Dockerhub searches
Search For Containers From %s=Søk etter containere fra %s
Search for similar containers=Søk etter lignende containere 

; Page Navigation
Displaying %s - %s of %s=Viser %1$s - %2$s (av %3$s)

Updating Content=
Language=Språk
Switch to this language=Bytt til dette språket
Country Code=Land kode
Install Language Pack=Installer Språkpakke
Remove Language Pack=Fjern Språkpakke
Update Language Pack=Oppdater Språkpakke
Installed Version=Installert versjon
A note about translations=Merknad om Oversettelser
Click here to view the language changelog=Klikk her for å se språkpakkens endringslogg

; Help Text
This chooses how to sort the results=Dette velger hvordan resultatene skal sorteres
These icons respectively will Install or Edit an application=Disse ikonene vil henholdsvis installere eller redigere et program
Clicking these icons will take you to an applications GUI or settings=Hvis du klikker på disse ikonene, kommer du til en applikasjons-GUI eller innstillinger
This will update an application=Dette vil oppdatere et program
This will take you to the appropriate support thread for an application=Dette tar deg til riktig støttetråd for en applikasjon
This will immediately switch to the language=Dette bytter umiddelbart til språket
This will take you to the project page for an application=Dette fører deg til prosjektsiden for en applikasjon
Clicking this icon will uninstall the application or delete it from the lists depending upon your current section=Ved å klikke på dette ikonet avinstalleres applikasjonen eller slettes fra listene, avhengig av din nåværende seksjon
Clicking these icons will pin or unpin an application for later viewer from the Pinned Apps section=Hvis du klikker på disse ikonene, festes eller løsnes et program for senere visning fra Festede Applkasjons-delen
Clicking this will display more information about the application NOTE You can also click on the applications icon to display more information=Ved å klikke på dette vises mer informasjon om applikasjonen. MERKNAD Du kan også klikke på applikasjonsikonet for å vise mer informasjon
Clicking this will display any warnings or extra comments about the application=Hvis du klikker på dette, vises advarsler eller ekstra kommentarer om applikasjonen
On the previous apps section you can select multiple applications to install simultaneously=I den forrige appdelen kan du velge flere applikasjoner som skal installeres samtidig
This is the recommended version to install by the application author themselves=Dette er den anbefalte versjonen å installere av programforfatteren selv
For support for this plugin visit=For støtte for dette pluginet besøk
To view the policies Community Applications has=For å se retningslinjene Community Applications har
